Body Love est un film pornographique franco-néerlando-allemand  de Lasse Braun sorti en 1977.


Synopsis


Fiche technique
Titre : Body Love
Réalisation : Lasse Braun
Scénario : Lasse Braun
Musique : Klaus Schulze,
Image : Peter Focus
Décors : Lasse Braun
Montage : Ina Daman • Bent Rohweder
Producteur : Manfred Metz
Société de production : Love Film Productions
Pays :  Allemagne  France  Pays-Bas
Année : 1976
Format : couleurs 35 mm
Genre : pornographique
Durée : 85 minutes
Dates de sortie :
Suède : 13 février 1978
Japon : 13 décembre 1980
Autres titres :
Allemagne : Das Porno Telefon


Distribution
Catherine Ringer : Martine (créditée comme Lolita Da Nova)
Jack Gatteau : le reporter
Glenda Farrel : Glenda
Gilda Arancio : Gilda (créditée comme Gilda Stark)
Jean-Gérard Sorlin : le baron
Tony Morena :
Gemma Giménez : l'esclave
Carmelo Petix :
Louison Boutin : Bill
Frédérique Souchier : une invitée
Chantal Virapin : une invitée (créditée comme Vicky Mesmin)
Carlo Manuguerra : un invité
Hans Sonntag : un invité
Christel Loris : une invitée (créditée comme Christine Louis)
Mike Lennart : un invité
Louise Maier : une invitée
Micky Love (créditée comme Michèle d'Agro)
Benoît Archenoul : Ben (créditée comme Romain Ximay)
Jean-Claude Baboulin : un invité


Production


Édition
France : DVD aux éditions Blue One, juillet 2008 coffret Lasse Braun (avec French blue et Sensations)
Allemagne : DVD aux éditions Tabu Film, 2009
États-Unis : DVD aux éditions Caballero, février 2006La bande originale du film, composée par Klaus Schulze, a été éditée par Metronome Records en 1977.


Notes et références


Liens externes
(en) Body Love sur l’Internet Movie Database
Body Love sur European Girls Adult Film Database
Body Love sur International Adult Film Database Portail de la pornographie   Portail du cinéma allemand   Portail du cinéma français