قد يقصد من «الاكمة»  :

الاكمة (إب) : محلة في قرية الجاشة، عزلة ميتم، مديرية إب، محافظة إب اليمنية
الاكمة (الاعدون) : مستوطنة في اليمن
الاكمة (الجب) : محلة في قرية الجب، عزلة العاقبة، مديرية فرع العدين، محافظة إب اليمنية
الاكمة (الحوائل) : محلة في قرية الحوائل، عزلة الوزيرة، مديرية فرع العدين، محافظة إب اليمنية
الاكمة (الحيمة الخارجية) : قرية في عزلة بني وليد، مديرية الحيمة الخارجية، محافظة صنعاء اليمنية
الاكمة (الخرف) : محلة في قرية الخرف، عزلة المشيرق، مديرية حبيش، محافظة إب اليمنية
الاكمة (الدلو) : محلة في قرية الدلو، عزلة العداني، مديرية ذي السفال، محافظة إب اليمنية
الاكمة (الرحوب) : محلة في قرية الرحوب، عزلة العنسيين، مديرية ذي السفال، محافظة إب اليمنية
الاكمة (الزاملية)
الاكمة (الزواني)
الاكمة (السبرة)
الاكمة (السياني) : محلة في قرية عشة، عزلة الدامغ، مديرية السياني، محافظة إب اليمنية
الاكمة (الشعر) : محلة في قرية الحدم صرم روحان، عزلة الا ملؤك، مديرية الشعر، محافظة إب اليمنية
الاكمة (الشهالي) : محلة في قرية الشهالي، عزلة المزاحن، مديرية فرع العدين، محافظة إب اليمنية
الاكمة (الصافية) : محلة في قرية الصافية، عزلة بني الضاحتين، مديرية حبيش، محافظة إب اليمنية
الاكمة (الضباري) : محلة في قرية الضباري، عزلة جبل خضراء، مديرية حبيش، محافظة إب اليمنية
الاكمة (الظهار) : محلة في الظبر، اليمن
الاكمة (الظهرة) : محلة في الظهرة، اليمن
الاكمة (العدين)
الاكمة (العر) : محلة في قرية العر، عزلة بني الفخر، مديرية حزم العدين، محافظة إب اليمنية
الاكمة (العزلة)
الاكمة (القبقبة) : محلة في القبقبة، اليمن
الاكمة (المجدورة) : محلة في المجدورة، اليمن
الاكمة (المدبغة) : محلة في قرية المدبغة، عزلة وادي ضباء، مديرية ذي السفال، محافظة إب اليمنية
الاكمة (المسيمير)
الاكمة (المعشار)
الاكمة (الهيجة)
الاكمة (بردان) : محلة في قرية بردان، عزلة المكتب، مديرية جبلة، محافظة إب اليمنية
الاكمة (بعدان) : محلة في قرية بيت امير الدين، عزلة الحيث، مديرية بعدان، محافظة إب اليمنية
الاكمة (بني الورد)
الاكمة (بيت الجديد) : محلة في قرية بيت الجديد، عزلة سير، مديرية بعدان، محافظة إب اليمنية
الاكمة (جبلة) : محلة في خطرة، اليمن
الاكمة (جولبة) : محلة في قرية جولبة، عزلة دلال، مديرية بعدان، محافظة إب اليمنية
الاكمة (حبير) : محلة في قرية حبير، عزلة حبير، مديرية ذي السفال، محافظة إب اليمنية
الاكمة (حبيش)
الاكمة (حزم العدين)
الاكمة (حمرة) : محلة في قرية حمرة، عزلة شوائط، مديرية ذي السفال، محافظة إب اليمنية
الاكمة (ذي البارات) : محلة في قرية ذي البارات، عزلة سير، مديرية بعدان، محافظة إب اليمنية
الاكمة (ذي السفال) : محلة في قرية العارضة، عزلة السيف، مديرية ذي السفال، محافظة إب اليمنية
الاكمة (ريمة)
الاكمة (صعفان) : قرية في عزلة بني عراف، مديرية صعفان، محافظة صنعاء اليمنية
الاكمة (فرع العدين)
الاكمة (مذيخرة)
الاكمة (مناخة) : قرية في عزلة بني جربن، مديرية صعفان، محافظة صنعاء اليمنية
الاكمة (وادي بوكر) : محلة في قرية بوكر، عزلة بني احمد والثلث، مديرية فرع العدين، محافظة إب اليمنية
الاكمة (وادي موعة) : محلة في قرية موعة، عزلة حقين، مديرية حزم العدين، محافظة إب اليمنية